x x x x x x x x x x  .  .  .  .  .  .  .  x  x  x  x  x  x  x  x  x  x  x  x  x  x  x  x  x  x  x  x  x  x  x  x  x  x  x  x  x  x  x  x  x  x  x  x  x  x  x  x  x  x  x  x  x  x  x  x  x  x  x  x
x x x x x x 8 8 8 8  8  8 10 10 10 10 10 10 10 10  x  x  x  x  x  x  x  x  x  x  x  x  x  x  x  x  x  x 28 28 28 28 28 28 30 30 30 30 30 30 30 30 30 30 30 30  x  x  x  x  x  x  x  x  x  x  x  x  x  
x x 8 8 8 8 8 8 8 8  8  8 10 10 10 10 10 10 10 10 10 10 10  x  x  x  x  x  x  x  x  x  x  x  x  x 28 28 28 28 28 28 28 28 30 30 30 30 30 30 30 30 30 30 30 30 30  x  x  x  x  x  x  x  x  x  x  x  x  
x x 8 8 8 8 8 8 8 8  8  8 10 10 10 10 10 10 10 10 10 10 10 10 10 10  x  x  x  x  x  x  x  x  x 28 28 28 28 28 28 28 28 28 30 30 30 30 30 30 30 30 30 30 30 30 30 30  x  x  x  x  x  x  x  x  x  x  x  
x x 8 8 8 8 8 8 8 8  8  8 10 10 10 10 10 10 10 10 10 10 10 10 10 10  x  x  x  x  x  x  x  x 28 28 28 28 28 28 28 28 28 28 30 30 30 30 30 30 30 30 30 30 30 30 30 30 30  x  x  x  x  x  x  x  x  x  x  
x x 8 8 8 8 8 8 8 8  8  8 10 10 10 10 10 10 10 10 10 10 10 10 10 10  x  x  x  x  x  x  x  x 28 28 28 28 28 28 28 28 28 28  x  x  x  x  x  x  x  x 32 32 32 32 32 32 32 32  x  x  x  x  x  x  x  x  x  
x x 6 6 6 6 6 6 6 6  6  6  x  x 12 12 12 12 12 12 12 12 12 12 12 12  x  x  x  x  x  x  x  x 26 26 26 26 26 26 26 26 26  x  x  x  x  x  x  x  x  x 32 32 32 32 32 32 32 32 32  x  x  x  x  x  x  x  x  
x x 6 6 6 6 6 6 6 6  x  x  x  x  x 12 12 12 12 12 12 12 12 12 12 12  x  x  x  x  x  x  x  x 26 26 26 26 26 26 26 26 26  x  x  x  x  x  x  x  x  x 32 32 32 32 32 32 32 32 32 32  x  x  x  x  x  x  x  
x x 6 6 6 6 6 6 6 x  x  x  x  x  x  x 12 12 12 12 12 12 12 12 12 12  x  x  x  x  x  x  x  x 26 26 26 26 26 26 26 26 26  x  x  x  x  x  x  x  x  x 32 32 32 32 32 32 32 32 32 32 32  x  x  x  x  x  x  
x x 6 6 6 6 6 6 x x  x  x  x 12 12 12 12 12 12 12 12 12 12 12 12  x  x  x  x  x  x  x  x  x 26 26 26 26 26 26 26 26 26  x  x  x  x  x  x  x  x  x 32 32 32 32 32 32 32 32 32 32 32  x  x  x  x  x  x  
x x 4 4 4 4 4 x x x  x 14 14 14 14 14 14 14 14 14 14 14 14  x  x  x  x  x  x  x  x  x  x  x 26 26 26 26 26 26 26 26 26  x  x  x  x  x  x  x  x  x 32 32 32 32 32 32 32 32 32 32 32  x  x  x  x  x  x  
x x 4 4 4 4 4 x x x  x 14 14 14 14 14 14 14 14 14 14  x  x  x  x  x  x  x  x  x  x  x  x  x 26 26 26 26 26 26 26 26 26  x  x  x  x  x  x  x  x  x 32 32 32 32 32 32 32 32 32 32 32  x  x  x  x  x  x  
x 4 4 4 4 4 4 x x x  x 14 14 14 14 14 14 14 14  x  x  x  x  x  x  x  x  x  x  x  x  x  x  x 26 26 26 26 26 26 26 26 26  x  x  x  x  x  x  x  x  x 32 32 32 32 32 32 32 32 32 32 32  x  x  x  x  x  x  
x 4 4 4 4 4 4 x x x  x 14 14 14 14 14 14  x  x  x  x  x  x  x  x  x  x  x  x  x  x  x  x  x 26 26 26 26 26 26 26 26 26  x  x  x  x  x  x  x  x  x 32 32 32 32 32 32 32 32 32 32 32  x  x  x  x  x  x  
x 4 4 4 4 4 4 x x x  x 14 14 14 14 14 14 14 14 14 14 14 14 14  x  x  x  x  x  x  x  x  x  x 26 26 26 26 26 26 26 26 26  x  x  x  x  x  x  x  x  x 32 32 32 32 32 32 32 32 32 32 32  x  x  x  x  x  x  
x 4 4 4 4 4 4 x x x 14 14 14 14 14 14 14 14 14 14 14 14 14 14 14  x  x  x  x  x  x  x  x  x 26 26 26 26 26 26 26 26 26  x  x  x  x  x  x  x  x  x 32 32 32 32 32 32 32 32 32 32 32  x  x  x  x  x  x  
x 2 2 2 2 2 x x x x 16 16 16 16 16 16 16 16 16 16 16 16 16 16 16 16  x  x  x  x  x  x  x  x 26 26 26 26 26 26 26 26 26  x  x  x  x  x  x  x  x  x 32 32 32 32 32 32 32 32 32 32 32  x  x  x  x  x  x  
x 2 2 2 2 2 x x x x 16 16 16 16 16 16 16 16 16 16 16 16 16 16 16 16 16  x  x  x  x  x  x  x 26 26 26 26 26 26 26 26 26  x  x  x  x  x  x  x  x  x 32 32 32 32 32 32 32 32 32 32 32  x  x  x  x  x  x  
x 2 2 2 2 2 x x x x 16 16 16 16 16 16 16 16 16 16 16 16 16 16 16 16 16 16  x  x  x  x  x  x  x 26 26 26 26 26 26 26 26  x  x  x  x  x  x  x  x  x 32 32 32 32 32 32 32 32 32 32 32  x  x  x  x  x  x  
x 2 2 2 2 2 x x x x  x 16 16 16 16 16 16 16 16 16 16 16 16 16 16 16 16 16 16  x  x  x  x  x  x  x 24 24 24 24 24 24 24 24  x  x  x  x  x  x  x  x  x 34 34 34 34 34 34 34 34 34 34  x  x  x  x  x  x  
x 2 2 2 2 2 x x x x  x  x 16 16 16 16 16 16 16 16 16 16 16 16 16 16 16 16 16 16  x  x  x  x  x  x  x 24 24 24 24 24 24 24 24  x  x  x  x  x  x  x  x  x 34 34 34 34 34 34 34 34 34  x  x  x  x  x  x  
x 2 2 2 2 2 x x x x  x  x  x  x  x  x  x  x  x  x  x  x 18 18 18 18 18 18 18 18  x  x  x  x  x  x  x  x 24 24 24 24 24 24 24 24  x  x  x  x  x  x  x  x  x 34 34 34 34 34 34 34 34 34  x  x  x  x  x  
0 0 0 0 0 0 x x x x  x  x  x  x  x  x  x  x  x  x  x  x  x 18 18 18 18 18 18 18  x  x  x  x  x  x  x  x  x 24 24 24 24 24 24 24 24  x  x  x  x  x  x  x  x  x 34 34 34 34 34 34 34 34 34  x  x  x  x  
0 0 0 0 0 0 x x x x  x  x  x  x  x  x  x  x  x  x  x  x  x 18 18 18 18 18 18 18  x  x  x  x  x  x  x  x  x  x 24 24 24 24 24 24 24 24  x  x  x  x  x  x  x  x  x 34 34 34 34 34 34 34 34 34  x  x  x  
0 0 0 0 0 0 x x x x  x  x  x  x  x  x  x  x  x  x  x  x  x 18 18 18 18 18 18 18  x  x  x  x  x  x  x  x  x  x  x 24 24 24 24 24 24 24 24  x  x  x  x  x  x  x  x  x 34 34 34 34 34 34 34 34 34  x  x  
0 0 0 0 0 0 x x x x  x  x  x  x  x  x  x  x  x  x  x  x  x 18 18 18 18 18 18 18  x  x  x  x  x  x  x  x  x  x  x  x 24 24 24 24 24 24 24  x  x  x  x  x  x  x  x  x  x 36 36 36 36 36 36 36 36 36 36  
0 0 0 0 0 0 x x x x  x  x  x  x  x  x  x  x  x  x  x  x  x 18 18 18 18 18 18 18  x  x  x  x  x  x  x  x  x  x  x  x 24 24 24 24 24 24 24  x  x  x  x  x  x  x  x  x  x 36 36 36 36 36 36 36 36 36 36  
0 0 0 0 0 0 x x x x  x  x  x  x  x  x  x  x  x  x  x  x  x 20 20 20 20 20 20 20  x  x  x  x  x  x  x  x  x  x  x 24 24 24 24 24 24 24 24  x  x  x  x  x  x  x  x  x  x 36 36 36 36 36 36 36 36 36 36  
0 0 0 0 0 0 x x x x  x  x  x  x  x  x  x  x  x  x  x  x  x 20 20 20 20 20 20 20 22 22 22 22 22 22 22 22 22 22 22 24 24 24 24 24 24 24  x  x  x  x  x  x  x  x  x  x  x 36 36 36 36 36 36 36 36 36 36  
0 0 0 0 0 0 x x x x  x  x  x  x  x  x  x  x  x  x  x  x  x 20 20 20 20 20 20 20 22 22 22 22 22 22 22 22 22 22 22 24 24 24 24 24 24  x  x  x  x  x  x  x  x  x  x  x  x 36 36 36 36 36 36 36 36 36 36  
0 0 0 0 0 0 x x x x  x  x  x  x  x  x  x  x  x  x  x  x  x 20 20 20 20 20 20 20 22 22 22 22 22 22 22 22 22 22 22 24 24 24 24 24  x  x  x  x  x  x  x  x  x  x  x  x  x 36 36 36 36 36 36 36 36 36 36  
0 0 0 0 0 0 x x x x  x  x  x  x  x  x  x  x  x  x  x  x  x 20 20 20 20 20 20 20 22 22 22 22 22 22 22 22 22 22 22 24 24 24 24  x  x  x  x  x  x  x  x  x  x  x  x  x  x 36 36 36 36 36 36 36 36 36 36  
0 0 0 0 0 0 x x x x  x  x  x  x  x  x  x  x  x  x  x  x  x  0  0  0  0  0  0  0  x  x  x  x  x  x  x  x  x  x  x  x  x  x  x  x  x  x  x  x  x  x  x  x  x  x  x  x  x  0  0  0  0  0  0  0  0  0  0