x x x x x x x x x x  8  8 10 10 10 10 10  x  x  x  x  x  x  x  x x   x  x  x  x
x x x x x x 8 8 8 8  8  8 10 10 10 10 10 10 10 10  x  x  x  x  x  x  x  x  x  x
x x 8 8 8 8 8 8 8 8  8  8 10 10 10 10 10 10 10 10 10 10 10  x  x  x  x  x  x  x
x x 8 8 8 8 8 8 8 8  8  8 10 10 10 10 10 10 10 10 10 10 10 10 10 10  x  x  x  x
x x 8 8 8 8 8 8 8 8  8  8 10 10 10 10 10 10 10 10 10 10 10 10 10 10  x  x  x  x
x x 8 8 8 8 8 8 8 8  8  8 10 10 10 10 10 10 10 10 10 10 10 10 10 10  x  x  x  x
x x 6 6 6 6 6 6 6 6  6  6  x  x 12 12 12 12 12 12 12 12 12 12 12 12  x  x  x  x
x x 6 6 6 6 6 6 6 6  x  x  x  x  x 12 12 12 12 12 12 12 12 12 12 12  x  x  x  x
x x 6 6 6 6 6 6 6 x  x  x  x  x  x  x 12 12 12 12 12 12 12 12 12 12  x  x  x  x 
x x 6 6 6 6 6 6 x x  x  x  x 12 12 12 12 12 12 12 12 12 12 12 12  x  x  x  x  x
x x 4 4 4 4 4 x x x  x 14 14 14 14 14 14 14 14 14 14 14 14  x  x  x  x  x  x  x
x x 4 4 4 4 4 x x x  x 14 14 14 14 14 14 14 14 14 14  x  x  x  x  x  x  x  x  x
x 4 4 4 4 4 4 x x x  x 14 14 14 14 14 14 14 14  x  x  x  x  x  x  x  x  x  x  x
x 4 4 4 4 4 4 x x x  x 14 14 14 14 14 14  x  x  x  x  x  x  x  x  x  x  x  x  x
x 4 4 4 4 4 4 x x x  x 14 14 14 14 14 14 14 14 14 14 14 14 14  x  x  x  x  x  x
x 4 4 4 4 4 4 x x x 14 14 14 14 14 14 14 14 14 14 14 14 14 14 14  x  x  x  x  x
x 2 2 2 2 2 x x x x 16 16 16 16 16 16 16 16 16 16 16 16 16 16 16 16  x  x  x  x
x 2 2 2 2 2 x x x x 16 16 16 16 16 16 16 16 16 16 16 16 16 16 16 16 16  x  x  x
x 2 2 2 2 2 x x x x 16 16 16 16 16 16 16 16 16 16 16 16 16 16 16 16 16 16  x  x
x 2 2 2 2 2 x x x x  x 16 16 16 16 16 16 16 16 16 16 16 16 16 16 16 16 16 16  x
x 2 2 2 2 2 x x x x  x  x 16 16 16 16 16 16 16 16 16 16 16 16 16 16 16 16 16 16
x 2 2 2 2 2 x x x x  x  x  x  x  x  x  x  x  x  x  x  x 18 18 18 18 18 18 18 18 
0 0 0 0 0 0 x x x x  x  x  x  x  x  x  x  x  x  x  x  x  x 18 18 18 18 18 18 18
0 0 0 0 0 0 x x x x  x  x  x  x  x  x  x  x  x  x  x  x  x 18 18 18 18 18 18 18
0 0 0 0 0 0 x x x x  x  x  x  x  x  x  x  x  x  x  x  x  x 18 18 18 18 18 18 18
0 0 0 0 0 0 x x x x  x  x  x  x  x  x  x  x  x  x  x  x  x 18 18 18 18 18 18 18
0 0 0 0 0 0 x x x x  x  x  x  x  x  x  x  x  x  x  x  x  x 18 18 18 18 18 18 18
0 0 0 0 0 0 x x x x  x  x  x  x  x  x  x  x  x  x  x  x  x 20 20 20 20 20 20 20
0 0 0 0 0 0 x x x x  x  x  x  x  x  x  x  x  x  x  x  x  x 20 20 20 20 20 20 20
0 0 0 0 0 0 x x x x  x  x  x  x  x  x  x  x  x  x  x  x  x 20 20 20 20 20 20 20
0 0 0 0 0 0 x x x x  x  x  x  x  x  x  x  x  x  x  x  x  x 20 20 20 20 20 20 20
0 0 0 0 0 0 x x x x  x  x  x  x  x  x  x  x  x  x  x  x  x 20 20 20 20 20 20 20
0 0 0 0 0 0 x x x x  x  x  x  x  x  x  x  x  x  x  x  x  x  0  0  0  0  0  0  0
